00100093
00208093
0aa00193
abcdf237
f1220213
0e1021a3
00000013
00000013
00000013
0e3025a3
