00000093
00000113
00002c23
01c02103
fe011ee3
01802083
