f0e7c0b7
38108093
00000113
000011b7
95518193
02302023
02c02103
00117113
fe011ce3
00100213
00120213
00120213
000011b7
a5518193
02302023
02c02103
00117113
fe011ce3
00120213
00120213
00120213
