00000013
00100113
09500193
00302a23
01c02103
fe010ee3
00000013
00000013
00000013
00000013
