39500093
00e7c137
38110113
00000193
02102023
02202223
02c02183
0011f193
fe019ce3
00100093
00108093
00108093
