00100093
00208093
00000113
0aa00193
abcdf237
f1220213
0e1021a3
0e3025a3
0e702103
fe011ee3
0e4025a3
0e702103
fe011ee3
0e0021a3
00000093
00108093
00108093
00108093
00108093
