00000113
000011b7
95518193
02302023
02102423
02c02103
00117113
fe011ce3
00100213
00120213
00120213
